Bimlavati : Pravesh Surinder Arun Renu Rewa Bubble Rummy ;
Surinder : Ratish Unnat Sadhvi ;
Arun : Ashish Kanika ;
Ashish : Yajur ;
Kanika : Ishani Achyut ;
Renu : Siddharth Shweta Bhuwan ;
Rewa : Vibhu Chetan Deepika ;
Deepika : Suvra Sachet ;
Vibhu : Komal ;
Chetan : Rahi ArjunK ;
Bubble : Meghna Ruchi ;
Munna : Arjun Mannat ;
Dolly : Dhruv Trishika AbhayS ;
Rummy : Sheetu Dolly Munna Tinku ;
Tinku : Shray ;
Sheetu : Maira Maanvi ;
Ratish : Simar ;
Unnat : Mehul ;
Sadhvi : Samyak ;
Siddharth : Pranet ;
Meghna : Vaibhav Poorva ;
Ruchi : Tanisha ;
Daddy : Indu Vinita Sanjoo ;
Indu : Shruti ;
Vinita : Sachin Shubhi ;
Sanjoo : Appu Mansha ;
Sachin : Divi ;
Appu : Arshia ;
Shubhi : Abhay Amishi ;
Devraj : Atul Akhil ;
Akhil : Mansi Aditya ;
Mansi : Kaira Agastya ;
Aditya : Zaira Sana ;